10000001110001001100000000000000
10000001110000000000000000000000
10000000000000000000000000000000
10000000000000000000000000000000
10000000000000000000000000000000
10111000110111000000000101101000
10000000000000000000000000000000
10000000000000000000000000000000
10011001000111000000000101101000
10000000000000000000000000000000
10000000000000000000000000000000
10011000110011000000000000000100
10011001000100000000000000000100
10000000000000000000000000000000
10000000000000000000000000000000
10000000000000000000000000000000
10000100000011010000000000000000
10010100000011000100000000000000
10100101110001001100000000000000
10001000010010000000000110010000
10011000110100000000000110010000
10101001010110000000000110010000
10111001110111000000000110010000
10000000000000000000000000000000
10000000000000000000000000000000
10000000000000000000000000000000
10111000110111000000000101101000
10000000000000000000000000000000
10000000000000000000000000000000
10000000000000000000000000000000
00000000110000111111111111111100
10000000000000000000000000000000
10000000000000000000000000000000
10000000000000000000000000000000
10000000000000000000000000000000
00010001000000111111111111110111
10000000000000000000000000000000
10000000000000000000000000000000
10000000000000000000000000000000
10000000000000000000000000000000
01010001010101000000000000000000
01000001000100000000000000000000
01010101100110000000000000000000
10000000000000000000000000000000
10000000000000000000000000000000
10000000000000000000000000000000
01000101100110000000000000000000
